All Of Me (John Legend Cover) 	[ All Of You I Give  ]
Someone Like You 	[ Adele  ]
Almost Lover 	[ A Fine Frenzy  ]
I'm Yours 	[ Jason Mraz  ]
You're Beautiful 	[ James Blunt  ]
Yellow 	[ Coldplay  ]
Young and Beautiful 	[ 鎷夊寰烽浄 Lana Del Rey  ]
See You Again (feat. Charlie Puth) 	[ Wiz Khalifa  ]
Let Her Go 	[ Passenger  ]
9 Crimes 	[ Damien Rice  ]
Counting Stars 	[ OneRepublic  ]
Free Loop 	[ Daniel Powter  ]
Wake Me Up When September Ends 	[ Green Day  ]
We Are Young 	[ Fun.  ]
Sugar 	[ Maroon 5  ]
Creep 	[ Radiohead  ]
Oceans Deep 	[ Sons Of Day  ]
Apologize 	[ OneRepublic  ]
If I Were a Boy / Single Ladies 	[ Beyonc茅  ]
Need You Now 	[ Lady Antebellum  ]
A Thousand Years 	[ Christina Perri  ]
Just One Last Dance 	[ Sarah Connor  ]
Shape Of My Heart 	[ Sting  ]
Yesterday Once More 	[ Carpenters  ]
Traveling Light 	[ Joel Hanson ]
Young For You 	[ GALA  ]
Breathless 	[ Shayne Ward  ]
If I Die Young 	[ The Band Perry  ]
Lucky 	[ Jason Mraz  ]
Try 	[ P!nk  ]
Hotel California 	[ Eagles  ]
Begin Again 	[ Various Artists  ]
What Are Words 	[ Chris Medina  ]
Viva La Vida 	[ Coldplay  ]
Take Me To Church 	[ Hozier  ]
Hello 	[ Adele  ]
Begin Again 	[ Taylor Swift  ]
Just Give Me a Reason  (feat. Nate Ruess) 	[ P!nk  ]
Take a Bow 	[ Rihanna  ]
Uptown Funk (feat. Bruno Mars) 	[ Mark Ronson  ]
Gotta Have You 	[ The Weepies  ]
Blower's Daughter 	[ Damien Rice  ]
Desperado 	[ Eagles  ]
Close to You 	[ Carpenters  ]
Heartbeats 	[ Amy Diamond  ]
Thinking Out Loud 	[ Ed Sheeran  ]
Style 	[ Taylor Swift  ]
Because of You 	[ Kelly Clarkson  ]
Lemon Tree 	[ Fool's Garden  ]
Reality 	[ Richard Sanderson  ]
Photograph 	[ Ed Sheeran  ]
The Lazy Song 	[ Bruno Mars  ]
Just the Way You Are 	[ Bruno Mars  ]
Hey, Soul Sister 	[ Train  ]